#######################
#               K     #
#           $         #
# KK#                 #
#   #        #K #     #
#   #        ####   # #
#   #    K          ###
#                     #
# K      #  ##        #
#      ###   #        #
#        ### #     @  #
#          # #        #
#######################