#######################
#@                    #
#                     #
#     ##### ##        #
#     ######## K      #
#     ######         K#
#     ###### #        #
#     ########        #
#                     #
#                    $#
#######################