#######################
#                     #
#                     #
# K#               @  #
#  #              #   #
#                 ##  #
#                     #
#            $        #
#                     #
#       K             #
#######################