################
#             K#
#              #
#              #
#              #
#              #
#              #
#              #
#              #
#     #        #
#K#            #
#$#   #     ## #
###   # ##  #  #
#@       #  ## #
################