#############
#           #
#           #
#     #     #
#K#         #
#$#   #     #
###   # ##  #
#@       #  #
#############