#################
#               #
# ############# #
#        #      #
# ######## #### #
# ############# #
# ############# #
# ############# #
# #             #
# # ########### #
# # #         # #
# # # ####### # #
# # # #     # # #
# # # # ### # # #
# # # # K$# # # #
# # # ##### # # #
# # #       # # #
# # ######### # #
# #           # #
# ############# #
#              @#
#################